severe_winter = {
	# BURGUNDY / Lower Burgundy
	407 
	# BURGUNDY / Upper Burgundy
	36 71 84 91 112 168 192 202 205 225 353 399 426 436 479 496 
	# HRE / Alemannia
	8 23 33 64 69 72 108 120 163 173 174 177 213 219 229 230 237 254 256 305 324 361 378 384 390 391 406 438 443 444 459 461 505 509 511 523 545 
	# HRE / Raetia
	5 14 18 19 24 40 41 68 74 88 92 94 127 146 179 186 201 240 241 242 252 259 307 325 328 331 337 341 349 352 358 362 372 382 383 392 412 415 439 453 492 495 
	# HRE / Schwaben
	80 532 
	# HRE / Österreich
	2 35 51 158 166 306 313 373 403 433 519 
	# ITALY / Lombardy
	13 15 54 164 227 315 318 326 347 357 369 478 483 
	# ITALY / Piemont
	221 222 424 437 520 
}
normal_winter = {
	# BURGUNDY / Lower Burgundy
	9 30 44 47 49 73 81 85 96 97 98 114 129 131 141 159 165 185 191 194 195 196 216 233 243 244 245 251 257 264 268 272 275 276 286 296 301 304 323 330 339 340 356 359 360 365 374 376 377 387 413 419 427 429 431 449 460 470 471 498 500 513 515 522 529 537 
	# BURGUNDY / Upper Burgundy
	4 10 11 16 29 31 32 43 46 55 61 62 66 78 89 90 100 102 109 121 123 124 128 134 144 154 160 162 193 200 203 204 208 209 210 212 218 232 249 255 261 269 281 287 299 321 335 379 388 396 400 405 417 422 435 440 454 458 465 475 477 484 485 502 508 514 527 535 540 
	# HRE / Alemannia
	6 12 17 21 22 27 34 38 39 42 48 56 60 63 65 70 75 76 83 86 87 93 95 99 101 103 105 115 122 130 138 139 140 143 145 149 151 155 157 161 169 170 172 175 181 183 187 190 197 198 206 207 211 215 217 220 234 235 236 238 248 250 253 258 260 262 265 267 270 274 278 280 282 283 285 292 294 311 314 317 319 327 334 336 342 348 363 375 381 385 386 389 401 408 410 432 442 445 447 448 450 451 455 457 462 469 473 476 486 489 490 506 507 510 512 516 521 524 525 536 538 541 542 544 548 
	# HRE / Baden
	79 133 142 246 322 344 394 397 414 
	# HRE / Bayern
	290 
	# HRE / Raetia
	7 273 333 430 503 
	# HRE / Schwaben
	3 26 28 50 53 57 59 117 126 135 137 147 152 184 224 226 231 279 288 293 298 310 316 329 332 338 350 367 402 456 463 468 480 481 482 497 504 530 
	# HRE / Österreich
	416 528 
	# ITALY / Lombardy
	52 125 148 188 214 247 320 371 421 
	# ITALY / Piemont
	20 132 182 289 411 534 
}
mild_winter = {
	# ITALY / Lombardy
	1 77 111 189 223 228 284 291 295 345 368 393 398 404 491 499 
	# ITALY / Piemont
	199 271 303 466 494 533 
}
#	NO WINTER = {
#		# NO KINGDOM
#		25 37 45 58 67 82 104 106 107 110 113 116 118 119 136 150 153 156 167 171 176 178 180 239 263 266 277 297 300 302 308 309 312 343 346 351 354 355 364 366 370 380 395 409 418 420 423 425 428 434 441 446 452 464 467 472 474 487 488 493 501 517 518 526 531 539 543 546 547 
#	}
